30 33
##############################
#............................#
#.##....############...###...#  
#..#...........##..#...###...#  
#..#...##......##..#...###...#  
#.##...##......#.............#  
#.##...##......#.............#  
#.#....#.......####...###..###  
###......########......#.....#  
##...................###.....#  
#......#########.......##....#  
#......#.......####.....#....#  
#......#.......#..#.....#....#  
#............................#  
#......#########.............#  
#..............####....####..#  
######...##########....#######  
#....#.......................#  
#.##....############...###...#  
#..#...........##..#...###...#  
#..#...##......##..#...###...#  
#.##...##......#.............#  
#.##...##......#.............#  
#.#....#.......####...###..###  
###......########......#.....#  
##...................###.....#  
#......#########.......##....#  
#......#.......####.....#....#  
#......#..........#.....#....#  
#............................#  
#......#########.............#  
#......................####..#  
##############################