48 22
################################################
#.......##.....###....###....#####......#......#
#.......##.....#........#....#...#......#......#
#.......##.....#........#....#...#......#......#
#.......##.....#........#....#...#......#......#
#.....####.....###....###....#..##......####...#
#..............................................#
##########...........#######...##......#########
#......###.............#.#..............##.....#
#......###.............#.#..............##.....#
#......###.............#.#..............##.....#
#..............####....#.#....####.............#
#..............####....#.#....####.............#
#......####....####....#.#....####.............#
#........##....####..#######..####.............#
#......................#.#............##.......#
#......................#.#............##.......#
#......................#.#.....................#
#.......###.............................##.....#
#.......###.............................##.....#
#.......###.............................##.....#
################################################

